and one slice of watermelon.

That night he had a stomachache.
watermelon
....................
.                  .
.                  .
.   f              .
. ....        .... .
.                  .
.       ....       .
.                  .
.                  .
.                  .
.       ....       .
.                  .
.                  .
....................
