On Tuesday he ate through two pears.

But he was still hungry.
pear
....................
.                  .
.                  .
.  f            f  .
. ....        .... .
.                  .
.       ....       .
.                  .
.                  .
.                  .
.       ....       .
.                  .
.         *        .
....................
