On Monday he ate through one apple.
....................
.       v          .
.                  .
.                  .
. ....        .... .
.          a       .
.       ....       .
.                  .
.                  .
.                  .
.                  .
.       ....       .
.                  .
.^        *        .
....................
