one lollipop,


apple
....................
.                  .
.                  .
.  f               .
. ....        .... .
.                  .
.       ....       .
.                  .
.                  .
.                  .
.       ....       .
.                  .
.                  .
....................
