one cupcake,


apple
....................
.                  .
.                  .
.                  .
. ....        .... .
.       f          .
.       ....       .
.                  .
.                  .
.                  .
.       ....       .
.                  .
.                  .
....................
