one sausage,


sausage
....................
.                  .
.                  .
.                  .
. ....        .... .
.                  .
.       ....       .
.                  .
.                  .
.                  .
.       ....       .
.              f   .
.                  .
....................
